8
8
 9 13 13 13 13 13 13 10
16  0  0  0  0  0  0 14
16  0  0  0  0  0  0 14
16  0  0  0  0  0  0 14
16  0  0  0  0  0  0 14
16  0  0  0  0  0  0 14
16  0  0  0  0  0  0 14
12 15 15 15 15 15 15 11