17
28
0  0  0  0  0  0  0  0  0  0  0  0  0  0  0  0  0  0  0  0  0  0  0  0  0  0  0  0 
0  0  0  0  0  0  0  0  0  0  0  0  0  0  0  0  0  0  0  0  0  0  0  0  0  0  0  0 
0  0  0  0  0  0  0  0  0  0  0  0  0  0  0  0  0  0  0  0  0  0  0  0  0  0  0  0 
9  13 13 13 13 13 13 13 13 13 13 13 13 18 17 13 13 13 13 13 13 13 13 13 13 13 13 10
16 0  0  0  0  0  0  0  0  0  0  0  0  8  6  0  0  0  0  0  0  0  0  0  0  0  0  14
16 0  1  5  5  2  0  1  5  5  5  2  0  8  6  0  1  5  5  5  2  0  1  5  5  2  0  14
16 0  8  0  0  6  0  8  0  0  0  6  0  8  6  0  8  0  0  0  6  0  8  0  0  6  0  14
16 0  4  7  7  3  0  4  7  7  7  3  0  4  3  0  4  7  7  7  3  0  4  7  7  3  0  14
16 0  0  0  0  0  0  0  0  0  0  0  0  0  0  0  0  0  0  0  0  0  0  0  0  0  0  14
16 0  1  5  5  2  0  1  2  0  1  5  5  5  5  5  5  2  0  1  2  0  1  5  5  2  0  14
16 0  4  7  7  3  0  8  6  0  4  7  7  2  1  7  7  3  0  8  6  0  4  7  7  3  0  14
16 0  0  0  0  0  0  8  6  0  0  0  0  8  6  0  0  0  0  8  6  0  0  0  0  0  0  14
12 15 15 15 15 2  0  8  4  7  7  2  0  8  6  0  1  5  5  3  6  0  1  15 15 15 15 11
0  0  0  0  0  16 0  8  1  5  5  3  0  4  3  0  4  7  7  2  6  0  14 0  0  0  0  0  
0  0  0  0  0  16 0  8  6  0  0  0  0  0  0  0  0  0  0  8  6  0  14 0  0  0  0  0  
0  0  0  0  0  16 0  8  6  0  26 15 30 25 25 31 15 27 0  8  6  0  14 0  0  0  0  0  
13 13 13 13 13 3  0  4  3  0  14 0  0  0  0  0  0  16 0  4  3  0  4  13 13 13 13 13
0  0  0  0  0  0  0  0  0  0  14 0  0  0  0  0  0  16 0  0  0  0  0  0  0  0  0  0  
15 15 15 15 15 10 0  1  2  0  14 0  0  0  0  0  0  16 0  0  0  0  0  0  0  0  0  0