36
28
0  0  0  0  0  0  0  0  0  0  0  0  0  0  0  0  0  0  0  0  0  0  0  0  0  0  0  0 
0  0  0  0  0  0  0  0  0  0  0  0  0  0  0  0  0  0  0  0  0  0  0  0  0  0  0  0 
0  0  0  0  0  0  0  0  0  0  0  0  0  0  0  0  0  0  0  0  0  0  0  0  0  0  0  0 
9  13 13 13 13 13 13 13 13 13 13 13 13 2  1  13 13 13 13 13 13 13 13 13 13 13 13 10
16 0  0  0  0  0  0  0  0  0  0  0  0  8  6  0  0  0  0  0  0  0  0  0  0  0  0  14
16 0  1  5  5  2  0  1  5  5  5  2  0  8  6  0  1  5  5  5  2  0  1  5  5  2  0  14
16 0  8  0  0  6  0  8  0  0  0  6  0  8  6  0  8  0  0  0  6  0  8  0  0  6  0  14
16 0  4  7  7  3  0  4  7  7  7  3  0  4  3  0  4  7  7  7  3  0  4  7  7  3  0  14
16 0  0  0  0  0  0  0  0  0  0  0  0  0  0  0  0  0  0  0  0  0  0  0  0  0  0  14
16 0  1  5  5  2  0  1  2  0  1  5  5  5  5  5  5  2  0  1  2  0  1  5  5  2  0  14
16 0  4  7  7  3  0  8  6  0  4  7  7  2  1  7  7  3  0  8  6  0  4  7  7  3  0  14
16 0  0  0  0  0  0  8  6  0  0  0  0  8  6  0  0  0  0  8  6  0  0  0  0  0  0  14
12 15 15 15 15 10 0  8  4  7  7  2  0  8  6  0  1  5  5  3  6  0  9  15 15 15 15 11
0  0  0  0  0  16 0  8  1  5  5  3  0  4  3  0  4  7  7  2  6  0  14 0  0  0  0  0  
0  0  0  0  0  16 0  8  6  0  0  0  0  0  0  0  0  0  0  8  6  0  14 0  0  0  0  0  
0  0  0  0  0  16 0  8  6  0  18 13 23 17 17 22 13 19 0  8  6  0  14 0  0  0  0  0  
13 13 13 13 13 11 0  4  3  0  14 0  0  0  0  0  0  16 0  4  3  0  12 13 13 13 13 13
0  0  0  0  0  0  0  0  0  0  14 0  0  0  0  0  0  16 0  0  0  0  0  0  0  0  0  0  
15 15 15 15 15 10 0  1  2  0  14 


